ក្បាល=kbal
ឈរ=chhor
ផ្ទាល់=ptorl
ខ្លួន=kloun
ទំព័រ=tompor
គួរ=kour,kuo
ប្រទេស=brotes,protes
បាន=ban
រក=rk,rok
ឃើញ=khernh
ចម្លើយ=jomlery,chomlery
សាលា=sala
រៀន=rean,rien
កើនឡើង=kernlerng
កើន=kern
ឡើង=lerng
សិក្សា=serksa
រោងចក្រ=rongjak,rongchak
គម្រប=kumrob
អាហារ=ahha,aha
ព្រះ=preas
អាទិត្យ=ahtit,atit
បួន=boun
នាក់=nak,neak
រវាង=roveang
រដ្ឋ=rort,roth
រក្សា=reaksa
ភ្នែក=pnek
ក្រោយ=kroy
អនុញ្ញាត=aknunhat,anunhat
ថា=tha
ក្រុង=krong
ដើម=derm
ឆ្លង=chlorng,chlong
កាត់=kat
កសិដ្ឋាន=kaksethan
លំបាក=lumbak,lombak
ចាប់=jab,chab
ផ្តើម=pderm
រឿង=rerng,rueng,roeung
ឆ្ងាយ=chngay
សមុទ្រ=samut,samot
គូរ=ku
ចាកចេញ=jakjenh,chakjenh,chakchenh
ចាក=chak,jak
ចេញ=jenh,chenh
ចុង=jong,chong
រត់=rot,rut
ខណៈ=kanak,kaknak
សារពត៌មាន=saporomean,sapormean
សារ=sa,sar
ពត៌មាន=pormean,poromean
ជិតស្និទ្ធ=jitsnet,jetsnet
ជិត=jit,chet
ស្និទ្ធ=snit,snet
យប់=yub,yob
ពិតប្រាកដ=pitbrakot,pitprakot
ពិត=pit
ប្រាកដ=brakot,prakot
ជីវិត=chivit,gvit,jivit
ប៉ុន្មាន=ponman,ponmarn
ភាគខាងជើង=phakkhangjeung
ភាគ=peak,pheak
ខាង=khang
ជើង=jerng,cherng,cheung
សៀវភៅ=seavphov
អនុវត្ត=anuvat,anouvat,aknuwat
វិទ្យាសាស្រ្ត=vityasas,vitiyasas,vicheasas
បរិភោគ=bariphouk,boriphouk
បន្ទប់=bantup,bontup
មិត្តភក្តិ=mitpheak
មិត្ត=mit,met
ភក្តិ=pheak
គំនិត=kumnit,komnit
ត្រី=trey
ភ្នំ=phnom,pnom
បញ្ឈប់=banhchhub
មូលដ្ឋាន=moulthan,multhan
ឮ=ler,leu
សេះ=seh,ses
មើល=meul,meul
ពណ៌=por
មុខ=mok,muk
ឈើ=chheu,chher
សំខាន់=samkhan,somkhan
បើកចំហរ=bekchamhor,berkchamhor
បើក=berk
ចំហរ=chamhor,chomhor
ហាក់=hak
រួម=roum
ស=sor
កុមារ=komar,koma
ដើរ=der
ឧទាហរណ៏=uteahoh,oteahoh
បន្ថយ=banthoy,bonthory
បន្ធូរ=bonthu,banthu
ក្រដាស=krodas
ក្រុម=krom,krom
តែងតែ=taengtae,tangtae
តែង=taeng
តន្ត្រី=tantrai,tantri,dontrey
សញ្ញា=sanha,sanhnha
ញឹកញាប់=nherknhorb,nherknhob
ញាប់=nhorb,nhab,nhob
ញឹក=nherk,nhek
លិខិត=likhet
រហូត=rohot
ដល់=dol
ម៉ា=ma
ទន្លេ=tonle
រថយន្ត=rothyon,rotyon
ថែ=thae,thea
រក្សា=reaksa,raksa
