ណាមួយ=namouy,nahmouy
ណា=na,nah
មួយ=mouy,muy,muoy
ឡើយ=lery,laey
ថ្មី=thmei,t'mei,tmey
ការងារ=kangea,kangea
ធ្វើ=tver,tveu,thveu,tve,thver
ជាផ្នែក=cheaphnek,jeaphnek,jeapnek
ផ្នែក=phnek,pnek,pnaek
យក=yk,yok
ទទួល=t'toul,ttul,t'tul,tortul,turtul,totul,totuol,totoul
កន្លែង=konlaeng,k'leng,k'laeng,k'lg,kanlaeng
បានធ្វើ=bantver
រស់=rous,rus
នៅ=nv,nov
ដែល=del,dl
បន្ទាប់=bontorb,bantorb,bontob
ត្រឡប់=trolop,trolob,tralob
មក=mk,mok
វិញ=vinh,venh
តិច=tic,tich,tek
តួច=tuoch,touch
តែមួយ=taemuy,taemouy
គត់=kot,kut
ជុំ=jum,chum
ម្នាក់=mnak,mneak,m'neak,m'nak
កាល=kal
ឆ្នាំ=chhnam,jnam,j'nam
បង្ហាញ=bonghanh,p'hanh,b'hanh
រៀងរាល់=reangrol,reangrorl,rieangrorl,rieangrol
រាល់=rorl,rol
រៀង=reang,rieng
ផ្តល់=pdol,p'dol
ឱ្យ=oy,aoy,aoiy
ក្រោម=krom,krorm,kraom
ឈ្មោះ=chhmous,chmous,j'mous,j'mus,ch'mous
យ៉ាង=yang
ខ្លាំង=klang,k'lang
តាមរយៈ=tamroyak,tamroyak,tamroyeak
តាម=tam
រយៈ=royeak,royak,royeak
គ្រាន់តែ=krornta,kronta,krontae,krorntae
គ្រាន់=krorn,kron
សំណុំ=somnom,samnom,somnum
បែបបទ=baebbot
បទ=bot,bort
បែប=beb,baeb
កាត់=kat
ទោស=tos,tus
អស្ចារ្យ=oscha,osja,ohsja
ដ៏=do,dor
គិត=ket,kit
ជួយ=chuoy,juy,jouy,juoy,chouy
ទាប=teab,teap
បន្ទាត់=bontort,bantort,bontot,bantot
ខុស=khos,kos,khus
វេន=ven,vein
មូលហេតុ=mulhet,moolhet
ច្រើន=j'rern,ch'rern,chren,chran
ន័យ=ney,nei
មុន=mun,mon
ពេល=pel,peil
ផ្លាស់ប្តូរ=plasbdo,plahbdo,plaspdo
ប្តូរ=pdo,blo,b'do,p'do
ផ្លាស់=plas,phlas
សិទ្ធិ=seth,sith
ក្មេង=kmeng,k'meng,kmaeng
ប្រុស=bros,pros
អាយុ=ahyuk,ayuk,ayu,ayou
ផង=pg,phg,phorng,phong
ដូច=doch,duch,dch
គ្នា=k'nea,knea
នាង=neang
បាន=ban,bn
ទាំង=teang,tang
អស់=os,ors
នោះ=nus,nos,nuh
ឡើង=lerng,leung
ប្រើ=brer,prer,proeu
វិធី=vithi,vithy
អំពី=ompi,ampi
ពួក=puk,puok,pouk
សរសេរ=sorse,sorseh,soseh,sorseh,sohseh
នឹង=ng,neng
ដូច្នេះ=dochchneh,dochjnes,dochchnes
យូរ=yu,you,yuo,yuu
រឿង=rerng,rueng,reurng
សូម=som,sorm
មើល=mer,merl
គាត់=kort,kot,koat,kuat
ពីរ=pi
បំផុត=bamphut,bomphot,bomphut
មនុស្ស=mnus,m'nus,mnos
ជាង=cheang,jeang,
ដឹង=deng,derng,dg
ទឹក=tek,terk
ហៅ=hav,hao
លើក=lerk,leuk
ដំបូង=dombong,dambong
ចុះ=jos,chos,choh
ភាគី=pheaki,pheakki
ម្ខាង=m'khang,mkang,mkhang,m'kang
ឥឡូវ=eylov,lov,lv,alov,ahlov
ស្វែង=svaeng,sveng,s'veng
រក=rok,rk,rork