ដូច=doch
ជា=chea,jea
ខ្ញុំ=k'nhom,knhom
របស់=robos,rbos
គាត់=kort,koat,kuat
ថា=tha
លោក=lok
បាន=ban,bn
គឺ=keu,kue
សម្រាប់=somrab,samrap
នៅ=nv,nov
លើ=ler, leu
មាន=mean,mian
ជាមួយ=jmouy,j'mouy,cheamouy,jeamouy
ពួក=pouk,puok
គេ=ke
ការ=ka,kar
មួយ=muy,muoy
នេះ=nis,nih
ពី=pi
ដោយ=doy,dory
ក្តៅ=kdav,k'dao,ktau
ពាក្យ=peak
ប៉ុន្តែ=pontae,ponte
ដែល=del,dail
ចំនួន=jomnoun,jomnuon,chamnuon
វា=vea,
អ្នក=nk,neak
ឬ=rue
នៃ=ney
ដើម្បី=dermbey,berm3,dambei
និង=ng,neng
ក្នុង=knong,k'nong
យើង=yg,yerng
អាច=arch,ach
ចេញ=jenh,chenh
ផ្សេង=pseng,phseng
ទៀត=tt,teat,tiet
នាក់=neak,nak
ធ្វើ=tver,thveu
ពេលវេលា=pelvelea
ពេល=pel
វេលា=velea,vela
ប្រសិនបើ=brosenber,prosenber,prasenber,
បើ=ber
ប្រសិន=brosen,prosen,prasen
នឹង=ng,neng
របៀប=r'beab,robeab,rbeab,robieb
និយាយ=yy,niyeay
គ្នា=k'nea,knea
ប្រាប់=brab,prab,prap
មិន=min,men
សំណុំ=somnom
បី=3,bey
ចង់=jg,jong,chong
ខ្យល់=k'jol,kjol,kjorl
ល្អ=laor,lao
ក៏=kor,k
លេង=leng,lg
តូច=toch,tuch
ចុងបញ្ចប់=jongbanhjob
ចុង=jong,chong
បញ្ចប់=banhjob,banhchob,p'job
ដាក់=dak
ផ្ទះ=pteas,ptas,teas
អាន=ahn,an,read
ដៃ=dai
កំពង់ផែ=kompongphae,kompongphea
ទំហំធំ=tumhomthom
ធំ=thom
ទំហំ=tumhom,tomhom,tomhum
អក្ខរាវិរុទ្ធ=akaravirut,akravirut
បន្ថែម=bonthaem,thaem,bonthem
សូម្បីតែ=sombeytae,som3tae
តែ=tae,tea
សូម្បី=sombey,som3
ទី=ti
ត្រូវ=trov,trv,troav,troav,treuv
ខ្ពស់=kpous,k'puos,kpuoh,kpuos
តាម=tam
សកម្មភាព=sakammapheap,sakammapiap
ហេតុ=het,haet
អ្វី=avey,ahvey,avei,ey
សួរ=sur,suor,sour
បុរស=boros,bros,boras
ផ្លាស់=p'las,plas,plahs
ប្តូរ=pdo,p'do,do,bdor
ទៅ=tov,tv
ពន្លឺ=ponleur,punleur,ponlu
ប្រភេទ=prophet,braphet,prapet
បិទ=bet,bit
រូបភាព=rouppheab,rubpheab
ភាព=pheab,pheap
រូប=rub,rup,rop,rob,ruk,
ព្យាយាម=p'cheayeam,pcheayeam,pjeayeam,p'jeayeam
ថ្មី=thmei,t'mei,tmey
ម្តង=m'dong,m'dg,mdong,mdoung
សត្វ=sat
ចំណុច=jomnoch,chomnoch,chamnoch,j'noch
ម្តាយ=mday,mdai,m'day
ពិភព=piphob,pipob,piphob
ក្បែរ=kbae,k'bae
កសាង=korsang,kosang,kasang
ខ្លួន=kloun,k'loun,khloun
ឯង=eng,aeng
ផែនដី=phendey
ផែន=phen,paen
ដី=dey
ឪពុក=ouvpuk,ovpuk